1111111111
11P0EC1111
1111111111
