1111111111111
10010E00000C1
100M01P111111
1100111110011
1111111111111