11111111111111111
10110100000PC00C1
11110101111110001
11C00001C0EC00C11
11111111111111111