111111111111111111111111111111
10000000000C000000000000000C01
100P00000000000000000000000001
10C00000C0EC000000000000000001
100000000000000000000000000001
100000000000000000000000000001
100000000000000000000000000001
101010111010111011101110000001
101110110010010010101100000001
101010111010010011101010000001
100000000000000000000000000001
10000000000000000000000C000001
100000C00000000000000000000001
100000000000000000000000000001
111111111111111111111111111111