1111111111111
1001010000001
100101P111111
11001011E0011
1111111111111