1111111111111
10010100000P1
1001010111111
1000000100E11
1111111111111