11111111111111111
1000100000PC00C01
10000000000010001
10C00000C0EC00C01
11111111111111111