111111111111111111111111111111
100000000000000000000000000001
10CCCC0C00C0000C0CCCC0CCCC0001
10C0000C00C0000C0C00C0C0000001
10CC000C00C0000C0CCCC0CCCC0001
10C0000C00C0000C0C0000C0000001
10C0000C00CCCC0C0C0000CCCC0001
100000000000000000000000000001
100000001110111100000000000001
100000010010000100000000000001
100000111110111100000000000001
100000000010100000000000000001
100000000010111100000000000001
100P0000000000000000000000E001
100000000000000000000000000001
111111111111111111111111111111